%%%%%%%%%%%%%%%%%%%%
%.           ..%   %
%.%%.%%.%%.%%.%% % %
%                % %
%%%%%%%%%%%%%%%%%% %
%.....           P %
%%%%%%%%%%%%%%%%%%%%
