%%%%%%%%%%%%%%%%%%%%
%.           ..%  P%
%.%%.%%.%%.%%.%% % %
%                % %
%%%%%%%%%%%%%%%%%% %
%.....             %
%%%%%%%%%%%%%%%%%%%%
