%%%%%%%%%%%%%%%%%%%%
%.   P       ..%   %
%.%%.%%.%%.%%.%% % %
%                % %
%%%%%%%%%%%%%%%%%% %
%.....             %
%%%%%%%%%%%%%%%%%%%%
