%%%%%%%%%%%%%%%%%%%%
%.           ..%   %
%.%%.%%.%%.%%.%% % %
%               P% %
%%%%%%%%%%%%%%%%%% %
%.....             %
%%%%%%%%%%%%%%%%%%%%
