%%%%%%%%%%%%%%%%%%%%%%%%%%%%%%
%.      % % % P            %.%
%       % % %%%%%% %%%%%%% % %
%       %        %     % %   %
%%%%% %%%%% %%% %% %%%%% % %%%
%   % % % %   %    %     %   %
% %%% % % % %%%%%%%% %%% %%% %
%       %     %%     % % %   %
%%% % %%%%%%% %%%% %%% % % % %
% %           %%     %     % %
% % %%%%% % %%%% % %%% %%% % %
%   %     %      % %   % %%% %
%.  % %%%%%      % %%% %    .%
%%%%%%%%%%%%%%%%%%%%%%%%%%%%%%