%%%%%%%%%%%%%%%%%%%%%%%%%%%%%%
%.      % % %              %.%
%       % % %%%%%% %%%%%%% % %
%       %        %     % %   %
%%%%% %%%%% %%% %% %%%%% % %%%
%   % % % %   %    %     %   %
% %%% % % % %%%%%%%% %%% %%% %
%       %     %%     % % %   %
%%% % %%%%%%% %%%% %%% % % % %
% %           %%     %    P% %
% % %%%%% % %%%% % %%% %%% % %
%   %     %      % %   % %%% %
%.  % %%%%%      % %%% %    .%
%%%%%%%%%%%%%%%%%%%%%%%%%%%%%%